Date,County,NumFacilities,Cases_Residents,Cases_Employees,Deaths,NH_TotalCases
2020-04-16,Adams,1,2,0,1,2
2020-04-16,Allegheny,18,121,34,26,155
2020-04-16,Beaver,2,61,9,10,70
2020-04-16,Berks,13,188,41,14,229
2020-04-16,Bucks,31,186,35,29,221
2020-04-16,Butler,3,9,8,2,17
2020-04-16,Carbon,2,11,1,5,12
2020-04-16,Chester,15,111,14,19,125
2020-04-16,Clarion,1,1,0,0,1
2020-04-16,Clearfield,1,1,0,0,1
2020-04-16,Columbia,1,12,2,0,14
2020-04-16,Cumberland,3,30,3,2,33
2020-04-16,Dauphin,3,35,2,1,37
2020-04-16,Delaware,34,299,34,49,333
2020-04-16,Erie,1,1,0,0,1
2020-04-16,Fayette,1,3,0,1,3
2020-04-16,Indiana,2,11,0,2,11
2020-04-16,Lackawanna,9,172,17,13,189
2020-04-16,Lancaster,17,210,48,23,258
2020-04-16,Lebanon,1,4,1,0,5
2020-04-16,Lehigh,10,112,25,10,137
2020-04-16,Luzerne,11,127,11,22,138
2020-04-16,Lycoming,1,0,1,0,1
2020-04-16,Mercer,1,1,0,0,1
2020-04-16,Monroe,6,59,18,13,77
2020-04-16,Montgomery,55,584,18,64,602
2020-04-16,Northampton,10,175,44,9,219
2020-04-16,Philadelphia,43,666,3,35,669
2020-04-16,Pike,1,17,1,1,18
2020-04-16,Susquehanna,3,30,3,1,33
2020-04-16,Washington,1,0,1,0,1
2020-04-16,Westmoreland,4,51,19,13,70
2020-04-16,York,1,0,1,0,1
2020-04-17,Adams,1,2,0,1,2
2020-04-17,Allegheny,19,134,34,30,168
2020-04-17,Beaver,2,67,10,10,77
2020-04-17,Berks,13,244,42,16,286
2020-04-17,Bradford,1,1,0,0,1
2020-04-17,Bucks,34,227,40,34,267
2020-04-17,Butler,3,10,8,2,18
2020-04-17,Carbon,2,13,1,6,14
2020-04-17,Chester,16,128,17,22,145
2020-04-17,Clarion,1,1,0,0,1
2020-04-17,Clearfield,1,1,0,0,1
2020-04-17,Columbia,1,12,2,0,14
2020-04-17,Cumberland,3,45,3,2,48
2020-04-17,Dauphin,3,36,2,1,38
2020-04-17,Delaware,37,375,38,49,413
2020-04-17,Erie,1,1,0,0,1
2020-04-17,Fayette,1,3,0,1,3
2020-04-17,Indiana,2,11,0,3,11
2020-04-17,Lackawanna,9,210,18,15,228
2020-04-17,Lancaster,18,223,52,24,275
2020-04-17,Lebanon,1,8,1,0,9
2020-04-17,Lehigh,11,124,26,12,150
2020-04-17,Luzerne,12,138,14,23,152
2020-04-17,Lycoming,1,0,1,0,1
2020-04-17,Mercer,1,1,0,0,1
2020-04-17,Monroe,7,63,18,13,81
2020-04-17,Montgomery,54,639,19,70,658
2020-04-17,Northampton,10,177,45,11,222
2020-04-17,Philadelphia,45,713,3,37,716
2020-04-17,Pike,1,17,1,1,18
2020-04-17,Susquehanna,3,36,3,1,39
2020-04-17,Washington,1,0,1,0,1
2020-04-17,Westmoreland,4,53,20,14,73
2020-04-17,York,2,3,1,0,4
2020-04-18,Adams,1,3,1,1,4
2020-04-18,Allegheny,27,159,48,34,207
2020-04-18,Beaver,3,166,10,26,176
2020-04-18,Berks,13,291,46,18,337
2020-04-18,Bucks,37,255,48,42,303
2020-04-18,Butler,3,10,9,2,19
2020-04-18,Carbon,2,29,1,7,30
2020-04-18,Chester,17,141,19,27,160
2020-04-18,Clarion,1,1,0,0,1
2020-04-18,Clearfield,1,1,0,0,1
2020-04-18,Columbia,1,13,2,0,15
2020-04-18,Cumberland,3,58,6,2,64
2020-04-18,Dauphin,3,45,2,3,47
2020-04-18,Delaware,37,397,41,54,438
2020-04-18,Erie,2,2,0,0,2
2020-04-18,Fayette,1,3,0,1,3
2020-04-18,Indiana,2,11,0,4,11
2020-04-18,Lackawanna,9,220,18,20,238
2020-04-18,Lancaster,18,238,53,25,291
2020-04-18,Lebanon,1,8,1,0,9
2020-04-18,Lehigh,14,140,28,12,168
2020-04-18,Luzerne,12,155,15,24,170
2020-04-18,Lycoming,1,0,1,0,1
2020-04-18,Mercer,1,1,0,0,1
2020-04-18,Monroe,7,65,18,15,83
2020-04-18,Montgomery,58,695,20,77,715
2020-04-18,Northampton,11,200,46,12,246
2020-04-18,Perry,1,2,0,0,2
2020-04-18,Philadelphia,46,735,3,36,738
2020-04-18,Pike,1,17,1,1,18
2020-04-18,Schuylkill,1,1,0,0,1
2020-04-18,Susquehanna,3,36,3,1,39
2020-04-18,Washington,3,4,1,1,5
2020-04-18,Westmoreland,4,80,20,14,100
2020-04-18,York,2,3,1,0,4
2020-04-19,Adams,1,5,1,1,6
2020-04-19,Allegheny,30,168,51,37,219
2020-04-19,Beaver,3,170,11,27,181
2020-04-19,Berks,14,333,47,36,380
2020-04-19,Bucks,38,272,51,48,323
2020-04-19,Butler,3,10,9,2,19
2020-04-19,Carbon,2,29,1,7,30
2020-04-19,Chester,19,147,19,28,166
2020-04-19,Clarion,1,1,0,0,1
2020-04-19,Clearfield,2,2,0,0,2
2020-04-19,Columbia,1,13,2,0,15
2020-04-19,Cumberland,3,64,6,2,70
2020-04-19,Dauphin,3,49,3,2,52
2020-04-19,Delaware,37,409,44,60,453
2020-04-19,Erie,2,2,0,0,2
2020-04-19,Fayette,1,3,0,1,3
2020-04-19,Indiana,2,11,0,4,11
2020-04-19,Lackawanna,9,224,18,23,242
2020-04-19,Lancaster,21,260,55,44,315
2020-04-19,Lebanon,1,8,1,0,9
2020-04-19,Lehigh,17,154,28,13,182
2020-04-19,Luzerne,12,165,15,27,180
2020-04-19,Lycoming,1,0,1,0,1
2020-04-19,Mercer,1,1,0,0,1
2020-04-19,Monroe,7,66,18,18,84
2020-04-19,Montgomery,64,761,20,121,781
2020-04-19,Northampton,12,214,48,19,262
2020-04-19,Perry,1,2,0,0,2
2020-04-19,Philadelphia,46,759,3,82,762
2020-04-19,Pike,1,18,1,1,19
2020-04-19,Schuylkill,1,1,0,0,1
2020-04-19,Susquehanna,3,40,3,3,43
2020-04-19,Washington,3,4,1,1,5
2020-04-19,Westmoreland,4,81,21,17,102
2020-04-19,York,2,4,1,0,5
2020-04-20,Adams,1,7,1,1,8
2020-04-20,Allegheny,31,179,57,39,236
2020-04-20,Beaver,3,181,11,30,192
2020-04-20,Berks,15,345,47,43,392
2020-04-20,Bucks,38,297,56,52,353
2020-04-20,Butler,3,10,9,2,19
2020-04-20,Carbon,2,29,2,7,31
2020-04-20,Chester,19,159,19,30,178
2020-04-20,Clarion,1,1,0,0,1
2020-04-20,Clearfield,2,2,0,0,2
2020-04-20,Columbia,1,13,2,0,15
2020-04-20,Cumberland,3,64,10,2,74
2020-04-20,Dauphin,3,54,4,2,58
2020-04-20,Delaware,37,427,45,68,472
2020-04-20,Erie,2,2,0,0,2
2020-04-20,Fayette,1,3,0,1,3
2020-04-20,Indiana,2,11,0,4,11
2020-04-20,Lackawanna,9,227,18,24,245
2020-04-20,Lancaster,22,269,56,50,325
2020-04-20,Lebanon,1,8,1,0,9
2020-04-20,Lehigh,17,158,29,13,187
2020-04-20,Luzerne,12,171,15,27,186
2020-04-20,Lycoming,2,0,2,0,2
2020-04-20,Mercer,1,1,0,0,1
2020-04-20,Monroe,7,66,18,18,84
2020-04-20,Montgomery,65,838,21,138,859
2020-04-20,Northampton,12,221,50,19,271
2020-04-20,Perry,1,4,0,0,4
2020-04-20,Philadelphia,47,795,3,89,798
2020-04-20,Pike,1,18,1,1,19
2020-04-20,Schuylkill,1,1,0,0,1
2020-04-20,Susquehanna,3,42,3,4,45
2020-04-20,Washington,3,6,1,1,7
2020-04-20,Westmoreland,4,85,22,17,107
2020-04-20,York,2,4,1,0,5
2020-04-21,Adams,1,8,3,1,11
2020-04-21,Allegheny,34,181,64,43,245
2020-04-21,Beaver,3,183,11,34,194
2020-04-21,Berks,18,349,48,48,397
2020-04-21,Bucks,40,321,59,63,380
2020-04-21,Butler,3,10,9,2,19
2020-04-21,Carbon,2,34,2,8,36
2020-04-21,Centre,1,1,0,1,1
2020-04-21,Chester,21,178,22,42,200
2020-04-21,Clarion,1,1,0,0,1
2020-04-21,Clearfield,2,2,0,0,2
2020-04-21,Columbia,2,53,10,8,63
2020-04-21,Cumberland,3,73,11,4,84
2020-04-21,Dauphin,3,56,9,3,65
2020-04-21,Delaware,39,466,51,71,517
2020-04-21,Erie,2,2,0,0,2
2020-04-21,Fayette,1,3,0,1,3
2020-04-21,Indiana,2,11,0,4,11
2020-04-21,Lackawanna,9,234,20,31,254
2020-04-21,Lancaster,22,291,60,56,351
2020-04-21,Lebanon,1,9,1,0,10
2020-04-21,Lehigh,19,178,33,18,211
2020-04-21,Luzerne,11,152,12,28,164
2020-04-21,Lycoming,2,0,2,0,2
2020-04-21,Mercer,1,1,0,0,1
2020-04-21,Mifflin,1,0,1,0,1
2020-04-21,Monroe,7,66,21,18,87
2020-04-21,Montgomery,66,879,26,151,905
2020-04-21,Northampton,11,254,62,22,316
2020-04-21,Northumberland,1,1,0,0,1
2020-04-21,Perry,1,4,0,0,4
2020-04-21,Philadelphia,49,864,3,112,867
2020-04-21,Pike,1,19,1,3,20
2020-04-21,Schuylkill,2,1,1,0,2
2020-04-21,Susquehanna,3,44,4,4,48
2020-04-21,Washington,3,6,2,1,8
2020-04-21,Westmoreland,5,86,23,18,109
2020-04-21,York,3,5,1,1,6
2020-04-22,Adams,1,8,3,1,11
2020-04-22,Allegheny,33,199,69,48,268
2020-04-22,Armstrong,1,1,0,0,1
2020-04-22,Beaver,3,191,11,38,202
2020-04-22,Berks,18,353,53,50,406
2020-04-22,Bucks,42,350,64,72,414
2020-04-22,Butler,3,10,9,2,19
2020-04-22,Carbon,2,34,3,8,37
2020-04-22,Centre,1,1,0,1,1
2020-04-22,Chester,23,196,24,44,220
2020-04-22,Clarion,1,1,0,0,1
2020-04-22,Clearfield,2,2,0,0,2
2020-04-22,Columbia,2,61,11,9,72
2020-04-22,Cumberland,3,76,16,4,92
2020-04-22,Dauphin,3,59,10,5,69
2020-04-22,Delaware,40,488,55,74,543
2020-04-22,Erie,2,2,0,0,2
2020-04-22,Fayette,1,3,0,1,3
2020-04-22,Indiana,2,11,0,4,11
2020-04-22,Lackawanna,10,248,23,36,271
2020-04-22,Lancaster,22,305,62,57,367
2020-04-22,Lebanon,1,9,1,0,10
2020-04-22,Lehigh,18,212,37,20,249
2020-04-22,Luzerne,12,164,13,34,177
2020-04-22,Lycoming,2,1,2,0,3
2020-04-22,Mercer,1,1,0,0,1
2020-04-22,Mifflin,1,0,1,0,1
2020-04-22,Monroe,7,69,21,18,90
2020-04-22,Montgomery,70,942,27,157,969
2020-04-22,Northampton,12,270,67,22,337
2020-04-22,Northumberland,1,1,0,0,1
2020-04-22,Perry,1,4,0,0,4
2020-04-22,Philadelphia,49,902,3,113,905
2020-04-22,Pike,1,19,1,3,20
2020-04-22,Schuylkill,2,1,1,0,2
2020-04-22,Susquehanna,3,44,4,4,48
2020-04-22,Washington,3,6,2,1,8
2020-04-22,Westmoreland,5,88,23,18,111
2020-04-22,York,3,5,1,1,6
2020-04-23,Adams,1,9,3,1,12
2020-04-23,Allegheny,32,227,74,49,301
2020-04-23,Armstrong,1,1,0,0,1
2020-04-23,Beaver,3,193,11,39,204
2020-04-23,Berks,17,365,55,49,420
2020-04-23,Bucks,41,383,76,73,459
2020-04-23,Butler,3,10,9,2,19
2020-04-23,Carbon,2,33,3,7,36
2020-04-23,Chester,22,217,24,49,241
2020-04-23,Clarion,1,1,1,0,2
2020-04-23,Clearfield,2,2,0,0,2
2020-04-23,Columbia,2,65,11,9,76
2020-04-23,Cumberland,3,86,17,6,103
2020-04-23,Dauphin,3,61,11,8,72
2020-04-23,Delaware,40,538,60,83,598
2020-04-23,Erie,3,2,1,0,3
2020-04-23,Fayette,1,3,0,1,3
2020-04-23,Indiana,2,11,0,4,11
2020-04-23,Lackawanna,10,261,29,39,290
2020-04-23,Lancaster,22,313,68,55,381
2020-04-23,Lawrence,1,0,1,0,1
2020-04-23,Lebanon,1,10,2,1,12
2020-04-23,Lehigh,19,235,38,25,273
2020-04-23,Luzerne,13,178,15,36,193
2020-04-23,Lycoming,2,1,2,0,3
2020-04-23,Mercer,1,1,0,0,1
2020-04-23,Mifflin,1,0,1,0,1
2020-04-23,Monroe,8,74,22,18,96
2020-04-23,Montgomery,69,1012,29,156,1041
2020-04-23,Northampton,12,295,71,23,366
2020-04-23,Northumberland,1,1,0,0,1
2020-04-23,Perry,1,4,0,0,4
2020-04-23,Philadelphia,51,925,4,91,929
2020-04-23,Pike,1,18,1,2,19
2020-04-23,Schuylkill,2,1,1,0,2
2020-04-23,Susquehanna,3,44,5,4,49
2020-04-23,Washington,3,6,2,1,8
2020-04-23,Westmoreland,5,88,25,18,113
2020-04-23,York,3,5,1,0,6
2020-04-24,Adams,1,14,3,1,17
2020-04-24,Allegheny,32,246,78,50,324
2020-04-24,Armstrong,1,1,0,0,1
2020-04-24,Beaver,3,204,16,39,220
2020-04-24,Berks,18,398,55,49,453
2020-04-24,Bucks,42,433,81,82,514
2020-04-24,Butler,3,10,9,2,19
2020-04-24,Carbon,2,38,3,10,41
2020-04-24,Chester,23,250,27,61,277
2020-04-24,Clarion,1,1,1,0,2
2020-04-24,Clearfield,2,2,0,0,2
2020-04-24,Columbia,2,66,12,9,78
2020-04-24,Cumberland,3,91,20,7,111
2020-04-24,Dauphin,3,66,11,10,77
2020-04-24,Delaware,40,579,61,90,640
2020-04-24,Erie,3,2,1,0,3
2020-04-24,Fayette,1,3,0,1,3
2020-04-24,Franklin,1,1,0,0,1
2020-04-24,Indiana,3,12,1,4,13
2020-04-24,Lackawanna,12,273,37,44,310
2020-04-24,Lancaster,23,327,72,57,399
2020-04-24,Lawrence,1,0,1,0,1
2020-04-24,Lebanon,1,11,2,1,13
2020-04-24,Lehigh,19,252,40,29,292
2020-04-24,Luzerne,13,190,19,39,209
2020-04-24,Lycoming,2,1,2,0,3
2020-04-24,Mercer,1,1,0,0,1
2020-04-24,Mifflin,1,0,1,0,1
2020-04-24,Monroe,8,76,23,18,99
2020-04-24,Montgomery,72,1099,31,161,1130
2020-04-24,Northampton,12,315,75,23,390
2020-04-24,Northumberland,1,1,0,0,1
2020-04-24,Perry,1,4,0,0,4
2020-04-24,Philadelphia,50,1022,4,91,1026
2020-04-24,Pike,1,18,1,2,19
2020-04-24,Schuylkill,2,1,1,0,2
2020-04-24,Susquehanna,3,44,9,4,53
2020-04-24,Washington,3,6,2,1,8
2020-04-24,Westmoreland,5,90,26,18,116
2020-04-24,York,3,5,1,0,6
2020-04-25,Adams,1,14,3,1,17
2020-04-25,Allegheny,32,251,81,52,332
2020-04-25,Armstrong,1,2,0,0,2
2020-04-25,Beaver,3,225,16,39,241
2020-04-25,Berks,18,406,55,49,461
2020-04-25,Bucks,43,482,85,89,567
2020-04-25,Butler,3,10,9,2,19
2020-04-25,Carbon,2,38,3,10,41
2020-04-25,Chester,26,273,31,66,304
2020-04-25,Clarion,1,1,1,0,2
2020-04-25,Clearfield,2,2,0,0,2
2020-04-25,Columbia,2,67,14,9,81
2020-04-25,Cumberland,3,97,28,7,125
2020-04-25,Dauphin,3,68,13,9,81
2020-04-25,Delaware,41,617,71,100,688
2020-04-25,Erie,3,3,1,0,4
2020-04-25,Fayette,1,3,0,1,3
2020-04-25,Franklin,1,2,0,0,2
2020-04-25,Indiana,3,12,1,4,13
2020-04-25,Lackawanna,12,285,40,46,325
2020-04-25,Lancaster,23,341,76,57,417
2020-04-25,Lawrence,1,0,1,0,1
2020-04-25,Lebanon,1,14,2,2,16
2020-04-25,Lehigh,20,281,46,31,327
2020-04-25,Luzerne,14,203,23,43,226
2020-04-25,Lycoming,2,2,2,0,4
2020-04-25,Mercer,1,1,0,0,1
2020-04-25,Mifflin,1,0,1,0,1
2020-04-25,Monroe,8,82,24,18,106
2020-04-25,Montgomery,72,1143,31,167,1174
2020-04-25,Northampton,12,341,79,23,420
2020-04-25,Northumberland,1,1,1,0,2
2020-04-25,Perry,1,4,0,0,4
2020-04-25,Philadelphia,50,1079,4,91,1083
2020-04-25,Pike,1,18,1,2,19
2020-04-25,Schuylkill,2,1,1,0,2
2020-04-25,Susquehanna,3,44,9,4,53
2020-04-25,Washington,3,6,2,1,8
2020-04-25,Westmoreland,5,120,26,19,146
2020-04-25,York,3,5,1,0,6
2020-04-26,Adams,1,14,3,1,17
2020-04-26,Allegheny,32,254,82,52,336
2020-04-26,Armstrong,1,2,0,0,2
2020-04-26,Beaver,3,229,17,39,246
2020-04-26,Berks,19,427,59,50,486
2020-04-26,Bucks,43,518,91,93,609
2020-04-26,Butler,3,10,9,2,19
2020-04-26,Carbon,2,38,3,10,41
2020-04-26,Chester,26,286,32,66,318
2020-04-26,Clarion,1,1,1,0,2
2020-04-26,Clearfield,2,2,0,0,2
2020-04-26,Columbia,2,70,16,9,86
2020-04-26,Cumberland,3,111,30,7,141
2020-04-26,Dauphin,3,75,13,9,88
2020-04-26,Delaware,42,636,78,101,714
2020-04-26,Erie,4,2,2,0,4
2020-04-26,Fayette,1,3,0,1,3
2020-04-26,Franklin,1,7,0,1,7
2020-04-26,Indiana,3,13,1,4,14
2020-04-26,Lackawanna,12,291,42,46,333
2020-04-26,Lancaster,23,361,78,57,439
2020-04-26,Lawrence,1,0,1,0,1
2020-04-26,Lebanon,1,17,2,2,19
2020-04-26,Lehigh,21,292,48,32,340
2020-04-26,Luzerne,14,217,24,44,241
2020-04-26,Lycoming,2,2,3,0,5
2020-04-26,Mercer,1,1,0,0,1
2020-04-26,Mifflin,1,0,1,0,1
2020-04-26,Monroe,8,85,25,18,110
2020-04-26,Montgomery,72,1182,32,168,1214
2020-04-26,Northampton,12,345,80,23,425
2020-04-26,Northumberland,1,1,1,0,2
2020-04-26,Perry,1,4,0,0,4
2020-04-26,Philadelphia,50,1115,4,91,1119
2020-04-26,Pike,1,18,2,2,20
2020-04-26,Schuylkill,2,2,1,0,3
2020-04-26,Susquehanna,3,44,9,4,53
2020-04-26,Washington,3,6,2,1,8
2020-04-26,Westmoreland,6,125,28,19,153
2020-04-26,York,4,7,2,0,9
2020-04-27,Adams,1,16,3,1,19
2020-04-27,Allegheny,31,257,84,58,341
2020-04-27,Armstrong,1,2,0,0,2
2020-04-27,Beaver,3,247,19,39,266
2020-04-27,Berks,19,434,59,51,493
2020-04-27,Bucks,45,536,96,100,632
2020-04-27,Butler,4,10,10,2,20
2020-04-27,Carbon,2,39,3,10,42
2020-04-27,Chester,27,299,33,66,332
2020-04-27,Clarion,1,1,1,0,2
2020-04-27,Clearfield,2,2,0,0,2
2020-04-27,Columbia,2,71,18,9,89
2020-04-27,Cumberland,3,120,33,7,153
2020-04-27,Dauphin,3,79,13,12,92
2020-04-27,Delaware,42,653,88,103,741
2020-04-27,Erie,4,2,2,0,4
2020-04-27,Fayette,1,3,0,1,3
2020-04-27,Franklin,2,11,0,1,11
2020-04-27,Indiana,3,13,1,4,14
2020-04-27,Lackawanna,13,319,45,46,364
2020-04-27,Lancaster,24,368,82,58,450
2020-04-27,Lawrence,2,0,2,0,2
2020-04-27,Lebanon,2,18,2,2,20
2020-04-27,Lehigh,21,299,49,35,348
2020-04-27,Luzerne,16,225,25,47,250
2020-04-27,Lycoming,2,2,3,0,5
2020-04-27,Mercer,1,1,0,0,1
2020-04-27,Mifflin,1,0,1,0,1
2020-04-27,Monroe,8,90,26,19,116
2020-04-27,Montgomery,72,1224,32,178,1256
2020-04-27,Northampton,12,347,83,23,430
2020-04-27,Northumberland,1,1,1,0,2
2020-04-27,Perry,1,4,0,0,4
2020-04-27,Philadelphia,50,1139,4,92,1143
2020-04-27,Pike,1,18,2,2,20
2020-04-27,Schuylkill,2,2,1,0,3
2020-04-27,Susquehanna,3,44,9,4,53
2020-04-27,Washington,3,6,2,1,8
2020-04-27,Westmoreland,6,128,28,19,156
2020-04-27,York,4,7,2,0,9
2020-04-28,Adams,1,16,3,1,19
2020-04-28,Allegheny,33,273,86,66,359
2020-04-28,Armstrong,1,3,3,0,6
2020-04-28,Beaver,3,247,19,52,266
2020-04-28,Berks,19,447,61,53,508
2020-04-28,Bucks,45,555,102,114,657
2020-04-28,Butler,4,11,10,2,21
2020-04-28,Carbon,3,40,3,11,43
2020-04-28,Centre,1,1,0,0,1
2020-04-28,Chester,28,315,37,72,352
2020-04-28,Clarion,1,1,1,0,2
2020-04-28,Clearfield,2,2,0,0,2
2020-04-28,Columbia,2,74,21,11,95
2020-04-28,Cumberland,3,125,35,8,160
2020-04-28,Dauphin,3,88,13,12,101
2020-04-28,Delaware,42,692,91,115,783
2020-04-28,Erie,4,3,2,0,5
2020-04-28,Fayette,1,3,0,1,3
2020-04-28,Franklin,3,12,1,1,13
2020-04-28,Indiana,3,13,1,4,14
2020-04-28,Lackawanna,13,335,50,54,385
2020-04-28,Lancaster,25,376,88,61,464
2020-04-28,Lawrence,2,0,2,0,2
2020-04-28,Lebanon,3,21,3,3,24
2020-04-28,Lehigh,21,315,55,41,370
2020-04-28,Luzerne,16,245,27,48,272
2020-04-28,Lycoming,2,2,3,0,5
2020-04-28,Mercer,1,1,0,0,1
2020-04-28,Mifflin,1,0,1,0,1
2020-04-28,Monroe,8,98,27,19,125
2020-04-28,Montgomery,73,1250,34,194,1284
2020-04-28,Northampton,12,428,90,27,518
2020-04-28,Northumberland,1,4,2,0,6
2020-04-28,Perry,1,4,0,0,4
2020-04-28,Philadelphia,50,1151,4,92,1155
2020-04-28,Pike,2,19,3,2,22
2020-04-28,Schuylkill,2,2,1,0,3
2020-04-28,Susquehanna,3,44,9,4,53
2020-04-28,Washington,3,6,2,1,8
2020-04-28,Westmoreland,7,131,28,20,159
2020-04-28,York,4,7,2,0,9
2020-04-29,Adams,1,16,3,4,19
2020-04-29,Allegheny,34,285,89,65,374
2020-04-29,Armstrong,1,3,4,0,7
2020-04-29,Beaver,3,251,20,58,271
2020-04-29,Berks,19,457,63,75,520
2020-04-29,Bucks,45,594,110,132,704
2020-04-29,Butler,4,11,10,2,21
2020-04-29,Cambria,1,1,0,0,1
2020-04-29,Carbon,2,41,3,11,44
2020-04-29,Centre,2,2,0,0,2
2020-04-29,Chester,28,349,38,88,387
2020-04-29,Clarion,1,1,1,0,2
2020-04-29,Clearfield,2,2,0,0,2
2020-04-29,Columbia,2,74,21,17,95
2020-04-29,Cumberland,3,148,37,13,185
2020-04-29,Dauphin,4,90,14,13,104
2020-04-29,Delaware,42,738,103,163,841
2020-04-29,Erie,4,3,2,0,5
2020-04-29,Fayette,1,3,0,1,3
2020-04-29,Franklin,4,15,1,2,16
2020-04-29,Indiana,3,13,1,4,14
2020-04-29,Lackawanna,13,345,50,65,395
2020-04-29,Lancaster,25,382,93,81,475
2020-04-29,Lawrence,2,0,2,0,2
2020-04-29,Lebanon,3,24,4,4,28
2020-04-29,Lehigh,22,329,60,48,389
2020-04-29,Luzerne,15,256,29,53,285
2020-04-29,Lycoming,2,5,3,0,8
2020-04-29,Mercer,1,1,0,0,1
2020-04-29,Mifflin,2,1,1,0,2
2020-04-29,Monroe,8,106,28,22,134
2020-04-29,Montgomery,76,1290,35,259,1325
2020-04-29,Northampton,12,451,95,49,546
2020-04-29,Northumberland,1,4,2,0,6
2020-04-29,Perry,1,4,0,0,4
2020-04-29,Philadelphia,50,1193,4,163,1197
2020-04-29,Pike,2,20,4,4,24
2020-04-29,Schuylkill,2,2,1,0,3
2020-04-29,Susquehanna,3,44,11,9,55
2020-04-29,Washington,3,6,2,1,8
2020-04-29,Westmoreland,8,131,29,22,160
2020-04-29,York,4,7,2,0,9
2020-04-30,Adams,1,16,3,4,19
2020-04-30,Allegheny,34,290,90,71,380
2020-04-30,Armstrong,1,3,4,0,7
2020-04-30,Beaver,3,256,22,58,278
2020-04-30,Berks,19,464,64,75,528
2020-04-30,Bucks,45,638,124,147,762
2020-04-30,Butler,5,12,10,2,22
2020-04-30,Cambria,1,1,0,0,1
2020-04-30,Carbon,2,43,4,12,47
2020-04-30,Centre,2,3,0,0,3
2020-04-30,Chester,27,392,43,98,435
2020-04-30,Clarion,1,1,1,0,2
2020-04-30,Clearfield,2,2,0,0,2
2020-04-30,Columbia,2,74,22,17,96
2020-04-30,Cumberland,4,160,38,14,198
2020-04-30,Dauphin,4,96,15,17,111
2020-04-30,Delaware,42,780,110,173,890
2020-04-30,Erie,4,3,2,0,5
2020-04-30,Fayette,1,3,0,1,3
2020-04-30,Franklin,4,18,3,2,21
2020-04-30,Indiana,3,13,1,4,14
2020-04-30,Lackawanna,13,361,51,64,412
2020-04-30,Lancaster,26,392,93,81,485
2020-04-30,Lawrence,2,0,2,0,2
2020-04-30,Lebanon,3,35,4,4,39
2020-04-30,Lehigh,22,347,65,49,412
2020-04-30,Luzerne,15,266,32,56,298
2020-04-30,Lycoming,2,11,3,0,14
2020-04-30,Mercer,1,1,0,0,1
2020-04-30,Mifflin,2,1,1,0,2
2020-04-30,Monroe,8,108,28,22,136
2020-04-30,Montgomery,77,1347,38,280,1385
2020-04-30,Northampton,12,458,101,55,559
2020-04-30,Northumberland,1,4,2,0,6
2020-04-30,Perry,1,4,0,0,4
2020-04-30,Philadelphia,51,1282,5,163,1287
2020-04-30,Pike,2,22,4,4,26
2020-04-30,Schuylkill,4,16,1,0,17
2020-04-30,Susquehanna,3,44,12,9,56
2020-04-30,Washington,3,6,2,1,8
2020-04-30,Wayne,1,0,1,0,1
2020-04-30,Westmoreland,8,132,29,22,161
2020-04-30,York,4,7,2,0,9
2020-05-01,Adams,1,17,3,4,20
2020-05-01,Allegheny,34,296,93,77,389
2020-05-01,Armstrong,1,4,4,0,8
2020-05-01,Beaver,3,274,23,60,297
2020-05-01,Berks,19,474,64,75,538
2020-05-01,Bucks,46,726,138,164,864
2020-05-01,Butler,5,12,10,2,22
2020-05-01,Cambria,1,1,0,0,1
2020-05-01,Carbon,2,44,4,12,48
2020-05-01,Centre,2,3,0,0,3
2020-05-01,Chester,28,409,45,98,454
2020-05-01,Clarion,1,1,1,0,2
2020-05-01,Clearfield,2,2,0,0,2
2020-05-01,Columbia,2,77,24,17,101
2020-05-01,Cumberland,3,162,41,16,203
2020-05-01,Dauphin,4,99,15,17,114
2020-05-01,Delaware,42,830,118,177,948
2020-05-01,Erie,4,3,2,0,5
2020-05-01,Fayette,1,3,0,1,3
2020-05-01,Franklin,5,26,5,2,31
2020-05-01,Indiana,3,13,1,4,14
2020-05-01,Lackawanna,13,366,55,66,421
2020-05-01,Lancaster,27,406,100,84,506
2020-05-01,Lawrence,2,0,2,0,2
2020-05-01,Lebanon,3,38,4,4,42
2020-05-01,Lehigh,22,373,77,54,450
2020-05-01,Luzerne,16,277,33,60,310
2020-05-01,Lycoming,2,14,3,0,17
2020-05-01,Mercer,1,1,0,0,1
2020-05-01,Mifflin,2,1,1,0,2
2020-05-01,Monroe,8,120,28,22,148
2020-05-01,Montgomery,77,1382,40,288,1422
2020-05-01,Northampton,13,472,104,55,576
2020-05-01,Northumberland,1,4,2,0,6
2020-05-01,Perry,1,4,0,0,4
2020-05-01,Philadelphia,51,1317,5,163,1322
2020-05-01,Pike,2,23,4,5,27
2020-05-01,Schuylkill,5,17,1,0,18
2020-05-01,Susquehanna,3,44,12,9,56
2020-05-01,Washington,3,6,2,1,8
2020-05-01,Wayne,1,0,1,0,1
2020-05-01,Westmoreland,8,130,30,22,160
2020-05-01,York,4,7,2,1,9
2020-05-02,Adams,1,17,4,4,21
2020-05-02,Allegheny,33,291,93,79,384
2020-05-02,Armstrong,1,4,4,0,8
2020-05-02,Beaver,2,281,22,61,303
2020-05-02,Berks,20,490,65,75,555
2020-05-02,Bucks,47,781,147,175,928
2020-05-02,Butler,5,12,10,2,22
2020-05-02,Cambria,1,1,0,0,1
2020-05-02,Carbon,2,45,4,12,49
2020-05-02,Centre,2,3,2,0,5
2020-05-02,Chester,29,434,47,103,481
2020-05-02,Clarion,1,1,1,0,2
2020-05-02,Clearfield,2,2,0,0,2
2020-05-02,Columbia,2,78,25,17,103
2020-05-02,Cumberland,4,169,42,16,211
2020-05-02,Dauphin,4,102,20,17,122
2020-05-02,Delaware,43,894,129,192,1023
2020-05-02,Erie,4,3,2,0,5
2020-05-02,Fayette,1,3,0,1,3
2020-05-02,Franklin,5,30,5,2,35
2020-05-02,Indiana,2,12,1,4,13
2020-05-02,Lackawanna,13,384,57,66,441
2020-05-02,Lancaster,27,420,107,89,527
2020-05-02,Lawrence,2,0,2,0,2
2020-05-02,Lebanon,4,42,6,5,48
2020-05-02,Lehigh,23,403,76,56,479
2020-05-02,Luzerne,16,290,35,64,325
2020-05-02,Lycoming,2,23,3,0,26
2020-05-02,Mercer,1,1,0,0,1
2020-05-02,Mifflin,2,1,1,0,2
2020-05-02,Monroe,8,123,28,22,151
2020-05-02,Montgomery,78,1415,45,294,1460
2020-05-02,Northampton,11,490,106,55,596
2020-05-02,Northumberland,1,6,2,0,8
2020-05-02,Philadelphia,52,1347,4,164,1351
2020-05-02,Pike,2,23,4,5,27
2020-05-02,Schuylkill,5,19,1,0,20
2020-05-02,Susquehanna,3,44,12,9,56
2020-05-02,Union,1,0,1,0,1
2020-05-02,Washington,3,6,2,1,8
2020-05-02,Wayne,1,0,1,0,1
2020-05-02,Westmoreland,8,129,30,23,159
2020-05-02,York,4,8,2,1,10
2020-05-03,Adams,1,19,0,4,19
2020-05-03,Allegheny,34,293,0,79,293
2020-05-03,Armstrong,1,4,0,0,4
2020-05-03,Beaver,3,281,0,61,281
2020-05-03,Berks,19,504,0,75,504
2020-05-03,Bucks,48,809,0,178,809
2020-05-03,Butler,5,12,0,2,12
2020-05-03,Cambria,1,1,0,0,1
2020-05-03,Carbon,2,45,0,12,45
2020-05-03,Centre,3,3,0,0,3
2020-05-03,Chester,31,443,0,104,443
2020-05-03,Clarion,1,1,0,0,1
2020-05-03,Clearfield,2,2,0,0,2
2020-05-03,Columbia,2,79,0,17,79
2020-05-03,Cumberland,5,173,0,16,173
2020-05-03,Dauphin,3,105,0,21,105
2020-05-03,Delaware,43,959,0,192,959
2020-05-03,Erie,4,3,0,0,3
2020-05-03,Fayette,1,3,0,1,3
2020-05-03,Franklin,5,41,0,2,41
2020-05-03,Indiana,3,13,0,4,13
2020-05-03,Lackawanna,14,401,0,69,401
2020-05-03,Lancaster,27,428,0,89,428
2020-05-03,Lawrence,2,0,0,0,0
2020-05-03,Lebanon,5,50,0,5,50
2020-05-03,Lehigh,25,424,0,57,424
2020-05-03,Luzerne,16,298,0,64,298
2020-05-03,Lycoming,2,26,0,1,26
2020-05-03,Mercer,1,1,0,0,1
2020-05-03,Mifflin,2,1,0,0,1
2020-05-03,Monroe,8,125,0,22,125
2020-05-03,Montgomery,79,1453,0,302,1453
2020-05-03,Northampton,13,505,0,55,505
2020-05-03,Northumberland,1,6,0,0,6
2020-05-03,Philadelphia,52,1370,0,164,1370
2020-05-03,Pike,2,28,0,5,28
2020-05-03,Schuylkill,6,26,0,0,26
2020-05-03,Susquehanna,3,44,0,9,44
2020-05-03,Union,1,0,0,0,0
2020-05-03,Washington,3,6,0,1,6
2020-05-03,Wayne,1,0,0,0,0
2020-05-03,Westmoreland,8,129,0,23,129
2020-05-03,York,4,8,0,1,8
2020-05-04,Adams,1,19,0,4,19
2020-05-04,Allegheny,35,302,0,79,302
2020-05-04,Armstrong,1,4,0,0,4
2020-05-04,Beaver,3,302,0,61,302
2020-05-04,Berks,20,522,0,75,522
2020-05-04,Bucks,48,834,0,178,834
2020-05-04,Butler,5,12,0,2,12
2020-05-04,Cambria,1,1,0,0,1
2020-05-04,Carbon,2,47,0,12,47
2020-05-04,Centre,3,4,0,0,4
2020-05-04,Chester,31,471,0,105,471
2020-05-04,Clarion,1,1,0,0,1
2020-05-04,Clearfield,2,2,0,0,2
2020-05-04,Columbia,2,82,0,17,82
2020-05-04,Cumberland,4,175,0,16,175
2020-05-04,Dauphin,3,110,0,21,110
2020-05-04,Delaware,43,978,0,195,978
2020-05-04,Erie,4,3,0,0,3
2020-05-04,Fayette,1,3,0,1,3
2020-05-04,Franklin,5,41,0,2,41
2020-05-04,Indiana,3,13,0,4,13
2020-05-04,Lackawanna,14,407,0,70,407
2020-05-04,Lancaster,27,434,0,90,434
2020-05-04,Lawrence,2,0,0,0,0
2020-05-04,Lebanon,5,54,0,5,54
2020-05-04,Lehigh,25,426,0,57,426
2020-05-04,Luzerne,16,301,0,67,301
2020-05-04,Lycoming,2,26,0,2,26
2020-05-04,Mercer,1,1,0,0,1
2020-05-04,Mifflin,2,1,0,0,1
2020-05-04,Monroe,8,125,0,22,125
2020-05-04,Montgomery,80,1492,0,303,1492
2020-05-04,Northampton,13,516,0,55,516
2020-05-04,Northumberland,1,6,0,0,6
2020-05-04,Philadelphia,52,1388,0,164,1388
2020-05-04,Pike,2,28,0,5,28
2020-05-04,Schuylkill,6,27,0,0,27
2020-05-04,Susquehanna,3,44,0,9,44
2020-05-04,Union,1,0,0,0,0
2020-05-04,Washington,3,6,0,1,6
2020-05-04,Wayne,1,0,0,0,0
2020-05-04,Westmoreland,8,129,0,23,129
2020-05-04,York,4,8,0,1,8
2020-05-05,Adams,1,19,4,4,23
2020-05-05,Allegheny,35,306,96,86,402
2020-05-05,Armstrong,1,5,4,1,9
2020-05-05,Beaver,3,305,23,66,328
2020-05-05,Berks,19,543,69,99,612
2020-05-05,Bucks,48,869,163,216,1032
2020-05-05,Butler,5,12,10,2,22
2020-05-05,Cambria,1,1,0,0,1
2020-05-05,Carbon,2,48,5,12,53
2020-05-05,Centre,3,4,4,0,8
2020-05-05,Chester,31,498,57,129,555
2020-05-05,Clarion,1,1,1,0,2
2020-05-05,Clearfield,2,2,0,0,2
2020-05-05,Columbia,2,82,27,19,109
2020-05-05,Cumberland,4,181,45,23,226
2020-05-05,Dauphin,3,132,29,21,161
2020-05-05,Delaware,42,1027,150,237,1177
2020-05-05,Erie,4,3,2,0,5
2020-05-05,Fayette,1,3,0,1,3
2020-05-05,Franklin,6,49,6,2,55
2020-05-05,Indiana,3,13,1,4,14
2020-05-05,Lackawanna,14,425,60,85,485
2020-05-05,Lancaster,27,453,114,121,567
2020-05-05,Lawrence,2,0,2,0,2
2020-05-05,Lebanon,5,55,9,9,64
2020-05-05,Lehigh,26,436,87,63,523
2020-05-05,Luzerne,16,308,46,68,354
2020-05-05,Lycoming,2,26,6,3,32
2020-05-05,Mercer,1,1,0,0,1
2020-05-05,Mifflin,2,1,1,0,2
2020-05-05,Monroe,8,127,28,25,155
2020-05-05,Montgomery,80,1509,49,355,1558
2020-05-05,Northampton,13,530,118,75,648
2020-05-05,Northumberland,1,6,2,0,8
2020-05-05,Philadelphia,53,1398,7,261,1405
2020-05-05,Pike,2,29,4,5,33
2020-05-05,Schuylkill,6,31,7,0,38
2020-05-05,Susquehanna,3,44,12,11,56
2020-05-05,Union,1,0,1,0,1
2020-05-05,Washington,3,6,2,1,8
2020-05-05,Wayne,1,0,1,0,1
2020-05-05,Westmoreland,8,129,30,24,159
2020-05-05,York,4,8,2,1,10
